.#...#.##.....#..#......#.##.#....#................#....#........##...#.#.##.#...............#.#
.............#.................#.####....................#..#....##...#......#.....#......#.....
..#..###.###......#..##....##.###.#..##....##....#..#.##......................###.#..##..#......
#.##...#............#........#.###..#.#####..##.#...####.#..##.##.###...#.....#.#.....###.#.....
...#.#..#..........##.....#...##.......##....#.....##...#..#..#.###.#.##.......#.....#.#.#...#..
##.....###....#..###.......#...........#.#........##.....#...###..#............#.......##..#...#
#.#.#..###....##....##..#.#.......#.#...........#..#.##....#.#.....#...............#......#.##..
.#..#.#...##.#..#.##..##.#........#.###.....#.........#....#.....#......#....#.#...........#....
.......#..##........#....#....#....##.#.............#...#.##..#.#.................#..#..##......
............#.#...###..#.##.....#.####.#...#....#....###.##....##.#..#..##...#.###.....#..#...#.
..#.......#...#.....#.....#..........#..#........#.##..####...#.#..#.....#......#..#.#......#..#
##....#....#....#...........#.#..#....#.....##.....#....##...........#.......................#.#
..##.....#....#.#.....#.##.....#....#....#.......#...##..###...###.#......#......#...###........
..#.....##..#.....#............#.#....#.#..#.##..#.#........##.......##...####.#.....#......#..#
....#.###.#....#...##....#.##.........#..##....#..#####.....#.####...#....##....##.....#.#......
.##..###....#.#.......#.#......#....#.....#...#.#..###....##..####..#.####.#..#.......##..#.#..#
.#..###.###...##.###...#.##...##..#..........#....###....##....#.##.#....#.###..#.####.###..#.#.
....#..##.......#..#..#..#......#.#.#...................#....#.#..#......#..##......#........#..
.....#...........##..#..#.##..#....##.#...........##.......#..#..#..#..#......####.##..........#
...#....#...###...#..###...#......###...#..#..#.#...###..#.###...#..#.##.......#....##..#......#
#...#..............#...#.#..#........#...###.#.#.#..#.#.........##..##........#.......##......#.
......#....#.....##............#....##..#...##..#..........#...#..#.#........##..#..#..#..#..#..
..........##.##.........#.....#.............#.#....#.###...#.##.......#...####.#..##....##..#.#.
....#..#...##.#.....##...##.#....#...#.....##.......#..##........#........#.#.#...........#..#..
..##.#..............#....#..#.#.####.#.##....##....##........#.#....##........#..#.#####..#..#..
......#.#...#.#.#..#...#..#....#...#..#..#..#.##.##................##...#.....#...###.####..#.##
..#.#....#..#..#..#.##...#..........#....#.###..#...........##..##..#...#.#..#.#.###.##.#.....##
.#.####...##...###.#..#......##.##.##...##..........##.........#....#...#.#......##.##...#......
#..###...#.....#..........#.#...#........#.#....#........#.....#..#..#.....#......##..##...#....
#.##..#.......###...#.#....###....##.#..###...#...........#.......#........#........#.####.#....
.##.........#...#.#.#.##.#....#..##.#.##..#..#.....#.#..........#........##..#.#....##..........
....#.##..##.#.##..#.##....#..#..#.#.....##..#...#....#........#.....#...#.#..##...#.....#......
....#..#...#.##.......##....##.#..............#...............##..#.....###....#.###..#.....#..#
#.#####..##...............#.....##...#.......#...###.....#.##.##....#.........#..##.....###...#.
........#.......####........#....#...#................#.##...##...#........#....#...#...#.##.##.
##....#.#..#.#........#....#.###..#...###.....#.#.....#...........#.#...#....#..###....#.......#
..#................#.#..#...#.##..#..#..#..####...###...#....#..##...#......##....##.#...#...#..
..#.............#.#.#.#..###...###....##..#.#.#..#..#......#.#....#........#..#.##..#..#...#....
##..#.#...#....#.....##...#..#..#..#....#..#...##.....#....#..#..........#.###.#..###...........
..#..#.#......###.#...................#......##..........#......#.........#.#...#..##.##........
#.#...#.#.....#........#....#.#.#.##....#..#......#.#.#....#..#....##..#..#.....#....###.......#
#...........##.............##....#..#..#...#.......#..#.#..........#.#.##.###.#..#....#...#....#
.#....#.#.#...........#...#..#....#...#..#.....##..#......#........#...#........#..#.##..#..##..
#.#....#.##.....#.#.....##.#####...##...#..#.......#.#......##.....##..##...#.......##...##....#
.................###.#...#...#..##.##...........#..##......#...#.#.#...###.#..####......#.##..#.
...#........#....#..#..#..##.#.##.##..#......##...#...........#.#..###.##.#..#.....##....#......
.###.........##..........#....##...#......#.##.....##...#.....................#........###..#.#.
.#.......##.......#..#....####.......#..####..#...........#....#...##.##..#............###.#.#..
...........#..#.####.##.#.......#.##......#.....#..........#....#.##...#.#.....#........#......#
.............#.#...##...##....#.............##.....#....#.###..#.#####.##...####.....#....#.....
........#..#.#.#..##....#....##.............#....##.........##.##..##.#.##.##..#...............#
.......###....#.#...#...#...............#........#....#.....#...#....##.#.....#...#...........#.
....###..#....#.......#...#..####....#........#.....#............#...#..#...#...###...#....###..
#.#....#.....................#.#...#..##.#..##.#....#....##..........#......###........###.....#
...##.###...###.....#..#....##..####..###....###......#.#.#...........#..#...#..#......#........
.........#..#..#..###.........#..#..#.#...#.....#.........................#....##.#..#..##......
......#....................##...###.#...##....#..#......#.#.......##..........#....#.####......#
.......#....................#...##........##.....##................#...##.......###..###.....#..
.##.....#....#.#..#....#.....#....##......#...##....##....#.##.....#....#...#.#.#.##.#.##..##.##
.#..#...#.....#.....####.#.###.##..##..##...#.......#.#..##.....#.....##....#....#.#....#...##..
##..........#.#.#.......###..##..##..#..##....#.#...##.#....#.#..##..###...#.#....#......#..#...
.#......#......#...#..........#.......#.....#......#...#........#.#.......#.##.#..#.#..###.#....
......##.#.....##...#....##....#.....##...........#...###...##.......##.#####.......#.#.....#...
....#......#.......#..#.#.##.##......#.#.##..#.........................#..#.....##.....#.#......
#...#....#.....#..#....#.#..........#....#.............#..####..#...........#.....#...#...#..#..
...#.#..##.....#..###....##.....#..#...#.#..#..#....####.####..#....#..#............#.......#...
......#..#...........#.#..#.#.#.....##.......#.....#.#....##.#.#..####..........##.#..#.....#...
#....###....##...###...#..####..#........##...#....#....#.#......#....#.....##.#.##..#......##..
#.....###..##.#..#..#.###.......##..##....#....................#.#...#...#..##.#...###........##
#...........#.#...#.#.........#..................#.#.........#.#...#.###.###..#...#..##..#......
#.#..#....#........###..#...#..........####.##..#..#..#......#..###...##...................#..#.
..........##.#......#....##...#.....####...##....##.#..#....#...#..#..#....#.....#.##.##........
...........#.##......#....#..###...........#.......#......#.##..#.#..##.....#...#.....#......#..
..###....#...........##.#..##....##.......#.........#.#..##.#.##.##..#...######.#...##..#.......
#..#.........#...##....#.#.....##............#....####....##..#.##....#...#.###......##.........
###....#.#....#...#....#....#...##.................###.#.....#.....#.#....#....#....#....#.#...#
...#.....#...#...##....##...........#...#......#.#........#.#...##......#...#..#.#.........#...#
.#.#...#......#..#.##..#..#..#......##..#....#....#.##.#...#.....##........#.....#..##.#..##.#..
#....#.....###....##..#.##...##.#.....#.............##.#.##.#.......#..........##.##....##.#.##.
...#....#.#.#..#.#...##....###.............#........#...#...#.#..#.........#..#......#....#...#.
..........##.#.....##.....#.#..........###.#..##..#.##..#.#..##.#..#...#.##.......#...........#.
#..#.#.....#......#.#..##.#....#.......##...##......#.......#...#.................##...#........
#....#..##...............##.#.#.......#....#.#....###..##.##.......##........###..#.....##.....#
..#..###.....#.#...............#................###......#..#.....#..####..#..#..#..#.#.........
..##...##..##....##.#..#.#.#.#...#..#......##........#..#....#...#####...##....##....#..#..##.#.
#.....#.#.#.#....#.#..#..#..#.#.#................#..##........#....#......#.........#.##.#.#....
##.###.......#.........#....#.##.##.##..#..#....#....#....#.#..###..#..###...#....#.......##.#..
..#.#......#..##...#....####..#.##....##....####..#.....#.#...#.#....##..#...###.......#......#.
#..##.#.#..#..#.......#..#....##..#.......#..#.##.......##...#.##..##.#.#.###....##.....#.......
.......#....#..#...#..#..#.#####.......#.#........#......#....#...#.....##..#............#......
##.##..#..#....####..####.##..##.#.........#......#..#.........#.....#..#.....#...#........#...#
#.........##...###.#..###...##...###..#...#..##.##....##.#.###............#...#.##..#.#.#....##.
.....#...#..#..##..#...#.......##..#.#...###.#......#.......#.##.#....#.#......#..#..#.#.##.....
......#....#...#.#...#.........##.#.....#...##.#.......##..####..##.#....#.#..#....#...##..#.#.#
...#......#......##.......#.....#..#...#...#..#...#......#.....##.#..........#.#................
......#...#....#.#.....#.#......#..............##..#.##...#......#...#.###.....#.#.#......#.##.#