.#...#.##.....#..#............#..###.#...........#......#........##...#.#.##.#...............#.# 
.............#...............#.#...#.#...........##.#..#.#..#....##...#......#......#.....#..... 
..#..###.###......#..##.....#...#..........##.......##........................###........#...... 
#.##...#............#...##...#..#.......###..##....##....#..##.##.###...#.....#.#.#.....#.#..... 
...#.#..#..........##...#.#.....##.#..###....#..####...##..#..#.###.#.##.......###.....#.#...#..
##.....###....#..###....##.##....##..#.#.#......##.#..#..#...###..#............#.##..#.##..#...# 
#.#.#..###....##....##..#..........####....................#.#.....#................#.....#.##.. 
.#..#.#...##.#..#.##..##..#.##.#.....#......#.......#......#.....#......#....#.#...........#.... 
.......#..##........#...#......#...##.#..#...#......#...#.##..#.#.................#..#..#..#.#.. 
............#.#...###..#...##.#.#.####.##....##.#....###.##....##.#..#..##...#.###.....#......#. 
..#.......#...#.....#...#............#...##.#..#.#.##..####...#.#..#.....#......#..#.#..#..#.... 
##....#....#....#.......#.....##.#....#.......#....#....##...........#.......................... 
..##.....#....#.#.....#..#.#........#.....##.....#...##..###...###.#......#......#...####.#..... 
..#.....##..#.....#..........#...#....#........#.#.#........##.......##...####.#.....#..#..#.... 
....#.###.#....#...##........##.......#.....#.....#####.....#.####...#....##....##.....#.#...#.. 
.##..###....#.#.......#..#....#.....#...........#..###....##..####..#.####.#..#.......##......## 
.#..###.###...##.###...#.##...##..#..........#....###..........#.##.#....#.###............#..#.. 
....#..##.......#..#..#..#......#.#.#....................##.#.....#......#..##......##...#.#..## 
.....#...........##..#..#.##..#....##.#...........##....#...#....#..#..#......###..#..#...#..#.. 
...#....#...###...#..###...#......###...#..#..#.#...###..........#..#.##.......###.......#...... 
#...#..............#...#.#..#........#...###.#.#.#..#.#...###.#.##..##........#...##....#......# 
......#....#.....##............#....##..#...##..#........#..#.....#.#........##....##.###....... 
..........##.##.........#.....#.............#.#....#.####.#....#......#...####.#...#......#..... 
....#..#...##.#.....##...##.#....#...#.....##.......#..##....##..#........#.#.#.#.####.#.#.#..## 
..##.#...........##.#..#.#..#.#.####.#.##....##....##........#.#....##..##..#.#..#.#####..#..#.. 
......#.#...#.#.##.#.#.#..#....#...#..#..#..#.##.##................##...#.#..##...###.####..#.## 
..#.#....#..#..#.#.#...#.#..........#....#.###..#...........##..##..#.......#....###.##.#.....## 
.#.####...##...#.............##.##.##...##..........##.........#....#.......#....##.##...#...... 
#..###...#.....#.#..#.##..#.#...#........#.#....#........#.....#..#..#.......#.#..##..##...#.... 
#.##..#.......##..##.#.....###....##.#..###...#...........#.......#.....#.#..#.#....#.####.#.... 
.##.........#...#...#..#.#....#..##.#.##..#..#.....#.#..........#........#.....#....##.......... 
....#.##..##.#.#...#.......#..#..#.#.....##..#...#....#........#.....#...#.........#.....#...... 
....#..#...#.##.......##....##.#..............#...............##..#.....###....#.###..#.....#..# 
#.#####..##...............#.....##...#.......#...###.....#.##.##....#.........#..##.....###...#. 
........#.......####........#....#...#................#.##...##...#........#....#...#...#.##.##. 
##....#.#..#.#........#....#.###..#...###.....#.#.....#...........#.#...#....#..###....#.......# 
..#................#.#..#...#.##..#..#..#..####...###...#....#..##...#......##....##.#...#...#.. 
..#.............#.#.#.#..###...###....##..#.#.#..#..#......#.#....#........#..#.##..#..#...#....
##..#.#...#....#.....##...#..#..#..#....#..#...##.....#....#..#..........#.###.#..###........... 
..#..#.#......###.#...................#......##..........#......#.........#.#...#..##.##........ 
#.#...#.#.....#...#..#....####..#.##....#..#......#.#.#....#..#....##..#.....#..#....###.......# 
#...........##..........##....#..#..#..#...#.......#..#.#..........#.#.#.#.......#....#...#....# 
.#....#.#.#.....#..#..#.#.#.##....#...#..#.....##..#......#........#...#..#..#.##..#.##..#..##.. 
#.#....#.##.......#.###...#...#....##...#..#.......#.#......##.....##..###..#.##....##...##....# 
.....................#.######.####.##...........#..##......#...#.#.#...#...#...###......#.##..#. 
...#........#....#........#..#..#.##..#......##...#...........#.#..###.#...........##....#...... 
.###.........##............##......#......#.##.....##...#................#.###.#.......###..#.#. 
.#.......##.....#........#.#.........#..####..#...........#....#...##.##.....#.........###.#.#.. 
...........#..#.####.##.#.......#.##......#.....#........................#.....#..#..#.#......## 
.............#.#...##...##....#.............##.....#.........#.#.#......#...#####......#........
........#..#.#.#..##....#....##.............#....##..........##...#.....##.##..##.......#.....## 
.......###....#.#...#...#...............#........#....#...........#...#.#.....#..#...###..###... 
....###..#....#.......#...#..####....#........#.....#......#.....##....##...#........#...#...... 
#.#....#.....................#.#...#..##.#..##.#....#...#.##.....#.##..#....###.........#....... 
...##.###...###.....#..#....##..####..###....###......#.#..###.##.#####..#...#....#..........#.. 
.........#..#..#..###.........#..#..#.#...#.....#...........#...#...##.#..#....#........#......# 
......#.....#....#..#......##...###.#...##....#.................#.............#....#.###......#. 
.......##.....#....#...#....#...##........##....##...#....##...#.##.....#.......###..###...#.... 
.##.....#......#....#........#....##......#...###...#................#.##...#.#.#.##.#.#....#.## 
.#..#....#.#...........#.#.###.##..##..##...#...#.##...#.#.#....###..##.....#....#.#.......#..#. 
##.......#.....#####....###..##..##..#..##....#..#.#.........##.##.....#...#.#....#.......##...# 
.#......#.#....##....#........#.......#.....#.....##......##.#......#.....#.##.#..#.#..###.##..# 
......##.................##....#.....##..............##.........#...#...#####.......#.#...#..... 
....#...................#.##.##......#.#.##..#........#......#.#....##....#.....##.....##......# 
#...#....#.....#...#.....#...##.....#......##..........#..####...#..#..#....#.....#...#...#..#.. 
...#.#..##.....#..###......#...##..#...#..##.###....####.####..###...###............#.......#... 
......#..#.........#.#...#..........##.............#.#....##.#.####.#...........##.#..#.....#... 
#....###....##..##.#..#........##............#.....#....#.#.......#...#.....##.#.##..#......##.. 
#.....###..##.#.#...###...####..##..##...#...##................#.#....#..#..##.#...###........## 
#...........#.#.#.#......#.#.#............#......#.#.........#.#..####...###..#...#..##..#...... 
#.#..#....#........###.......##........##..#..#.#..#..#......#..#..#.......................#..#. 
..........##.#..#....#........#.....####......#..##.#..#....#..........#...#.....#.##.##........ 
...........#.##......#....#..###............#......#......#.##..#.#..##..#..#.....#..........#.. 
..###....#...........##.#..##....##.................#.#..##.#.##.##..#..#...........##.##....... 
#..#.........#...##....#.#.....##.........#....#..####....##..#.##....#.....#...#.##..#......... 
###....#.#....#...#....#....#...##......#......#...###.#.....#.....#.#..#..#...#......#..#.#...# 
...#.....#...#...##....##...........#............#........#.#...##......#....#.....#.......#...# 
.#.#...#......#..#.##..#..#..#......##....#.......#.##.#...#.....##......###.#...##.......##.#.. 
#....#.....###....##..#.##...##.#.....#......#......##.#.##.#.......#....######...##...###.#.##. 
...#....#.#.#..#.#...##....###..............#.......#...#...#.#..#.........#.....#.....#..#...#. 
........##..#.......#....#..####.......###.#..##.....#..#.#..##.#..#...#.##.......#...........#. 
#..#.#....#.....#.......##.#...........##...##....#....#....#...#.................##...#........ 
#....#.....#.#.#.#..#.#..#.#..#.......#....#.#....##..#.#.##.......##........###..#.....##.....# 
..#..###...##..##..#.##...#.#.#...................#......#..#.....#..####..#..#..#..#.#......... 
..##...##.#.............#........#..#......##........####....#...#####...##....##....#..#..##.#. 
#.....#.......##.........#.#.##.#...............#..###........#....#......#.........#.##.#.#.... 
##.###......#...#..#.#..#....#.#.##.##..#..#.......#......#.#..###..#..###...#....#.......##.#..
..#.#.....#.##.....##......#.#..##....##....####..##.#..#.#...#.#....##..#...###.......#......#. 
#..##.#.#....#........#..#....##.......##.......#.......##...#.##..##.#.#.###....##.....#....... 
.......#.....#.....#..#..#.######...#..#.#..#.....#......#....#...#.....##..#............#...... 
##.##..##...#...###..####.##..##.....#.##.##...#..#..#.........#.....#..#.....#...#........#...# 
#.......#..#..#.##.#..###...##....#.#..#..#.###.##....##.#.###............#...#.##..#.#.#....##. 
.....#..#...##..#..#...#.......#.#..###..##..#......#.......#.##.#....#.#......#..#..#.#.##..... 
......#.#....#...#...#.........#......#.....#..........##..####..##.#....#.#..#....#...##..#.#.# 
...#....#..#.....##.......#.....#.............#...#......#.....##.#..........#.#................ 
......#..#..#..#.#.....#.#...........#..#.#..#..#..#.##...#......#...#.###.....#.#.#......#.##.#