.#...#.##.....#..#......#.##.#....#................#....#........##...#.#.##.#...............#.#
.............#.................#.####....................#..#....##...#......#.....#......#.....
..#..###.###......#..##....##.###.#..##....##....#..#.##......................###.#..##..#......
#.##...#............#........#.###..#.#####..##.#...####.#..##.##.###...#.....#.#.....###.#.....
...#.#..#..........##.....#...##.......##....#.....##...#..#..#.###.#.##.......#.....#.#.#...#..
##.....###....#..###.......#...........#.#........##.....#...###..#............#.......##..#...#
#.#.#..###....##....##..#.#.......#.#...........#..#.##....#.#.....#...............#......#.##..
.#..#.#...##.#..#.##..##.#........#.###.....#.........#....#.....#......#....#.#...........#....
.......#....#.#.....#....#....#....##.#...#...#.....#.....##..###.......##.#..#.......##..#.#..#
........#.#....#..###..#.##.....#.####.#.##....##....###....#.###.#..#....##....##.....#.#......
..#.....##..#.......#.....#..........#..#..#.##..#.##..#....##..#..#......####.#.....#......#..#
##....#..#....#.#...........#.#..#....#..#.........#.....###...#.....#....#......#...###........
..##.......#....#.....#.##.....#....#.......##...#...##.##......##.#.........................#.#
..#.......#...#...#............#.#....#.#........#.#....###...#......##..#......#..#.#......#..#
....#.##....#.#....##....#.##.........#....#......#####..##....###...#..##...#.###.....#..#...#.
.##..###..##..........#.#......#....#...........#..###..#.##..#.##..#.##..........#..#..##......
.#..###....##.#..###...#.##.#.....#........##.....###...#........##.#.....#.#.#...........#..#..
....#..#..##.##.#..#..#.#.....#.#.#.#.......#.#............#.##...#.......####.#..##....##..#.#.
.....#.....#.....##..#.........#...##.#.#...##....##.......#...#.#..#..#.....##..#..#..#..#..#..
...#..............#..###.#..#.....###....###.#.##...###..........#..#.##......#.......##......#.
#...#...#...###....#...#...#.........#..#..#..#..#..#.#..#.###..##..##.........#....##..#......#
......#..........##.....#.##..#.....##..........#..........#..#...#.#.........####.##..........#
........#................#.........................#.####....#.#......#..#..##......#........#..
....#..####...##....##...##...##.#...#.......#......#..#.##....#.#.......#.###..#.####.###..#.#.
..##.#....##.#.##..#.##..#..#.#.####.#.##....##....##..........#.....#...#.#..##.#.#####..#..#..
......#.....#...#.#.#.##..#....#...#..#..#..#.##.##.............#........##..#.#..###.####..#.##
..#.#.........###...#.#..#..........#....#.###..#.........#.......#........#.....###.##.#.....##
.#.####..#.....#.............##.##.##...##..........##...#.....#..#..#.....#.....##.##...#......
#..###....##...###.#..#...#.#...#........#.#....#..............#....#...#.#.......##..##...#....
#.##..#..#..#..#..#.##.....###....##.#..###...#.............##..##..#...#.#..#.#....#.####.#....
.##.....#...#.#.#..#...#.#....#..##.#.##..#..#.....#.#.............##...#.....#.....##..........
....#.##............#......#..#..#.#.....##..#...#....#......#.#....##........#....#.....#......
....#..#...#.##.#.#...................#......##..........#........#.......#.#...#..##.##....#..#
#.#####..##..........##...#..#..#..#....#..#...#.###.......#..#.....#....#.###.#..###...###...#.
........#.......#.#.#.#..###...###....##..#.#.#.......#....#.#....#........#..#.##..#..##.##.##.
##....#.#..#.#.....#.#..#...#.##..#..#..#..####.#.....#.#....#....#.#.......##....##.#.........#
..#...................#....#.###..#...###.....#...###...........##...#..#....#..###....#.#...#..
..#.............####........#....#...#...........#..#...##...##...#........#....#...#......#....
##..#.#...#....#..........#.....##...#.......#..#.....#..#.##.##..............#..##.............
..#..#.#......##......##....##.#..............#...............###.......###....#.###..#.........
#.#...#.#.....#........#..####..#.##....####..#...........#....#...##..#..#............###.#.#..
#...........##...........#....##.#..#..#..#.##.....##...#..........#.#.##.###.#........###..#.#.
.#....#.#.#...........#...##.#.#..#...#......##...#...........#....#...#...........##....#......
#.#....#.##.....#.#......#...#.....##...........#..##......#...#...##..##...#...##......#.##..#.
.................###.#..##.#######.##...#..#.......#.#......##...#.#...###.#..##....##...##....#
...#........#....#..#..#..#..#..#.##..#..#.....##..#......#.....#..###.##.#..#..#..#.##..#..##..
.###.........##............##......#.......#.......#..#.#.....................#..#....#...#....#
.#.......##.......#..#......#.#......#..#..#......#.#.#....#..#....##.##..#.....#....###.......#
...........#..#...###.........#..#..#.#...#.....#..........#....#.##...#.#.....#........#......#
.............#.#....#..#....##..####..###....###...#....#.###..#.#####.##...####.....#....#.....
........#..#.#.#.............#.#...#..##.#..##.#.##.........##.##..##.#.##.##..#...............#
.......###....#.......#...#..####....#........#..#....#.....#...#....##.#.....#...#...........#.
....###..#....#.#...#...#...............#...........#............#...#..#...#...###...#....###..
#.#....#..........##....#....##.............#.......#....##..........#......###........###.....#
...##.###...###....##...##....#.............##........#.#.#...........#..#...#..#......#........
.........#..#..#####.##.#.......#.##......#.....#.........................#....##.#..#..##......
......#....#............#.##.##.###.#....##..#....................##......#........#.###.#......
.......#.#.....#.........##....###................#...###...##.....#...######...###..###....#...
.##.....#......#..#....#......#...##........#......#...#...........#......#.##.##.##.#.###.#....
.#..#.......#.#.....#######..##.#..##..###....#.#...##.#....#.#.#.....##...#.#...#.#.....#..#...
##......#.....#.#........#.###.#.##..#..#...#.......#.#..##......##..###....#.....#.....#...##..
.#......#....#.#...#.........#........#...#...##....##....#.##..#.#.....#...#.#...#.#..##..##.##
......##........#...#.......#........##...##.....##..................##.#...........#.#......#..
....#..............#..#....##........#.###....#..#......#.#............#......#.##.....##......#
#...#....#.....#..#....#.##...#.....####...##....##.#..#....#...#..........#......#...#...#..#..
...#.#..##.....#..###...#...#..........####.##..#..#..#......#......#..#............#.......#...
......#..#...........#.#......#..................#.#.........#.#..####...###..#.##.#..#.....#...
#....###....##...###...##.......##..##....#....................#.#....#..#..##.#.##..#......##..
#.....###..##.#..#..#.##..####..#........##...#....#....#.#......#...#......##.#...###........##
#...........#.#...#.#.....#.#.#.....##.......#.....#.#....##.#.#...#.###..........#..##..#......
#.#..#....#........###...##.....#..#...#.#..#..#....####.####..####...##...................#..#.
..........##.#......#....#..........#....#.............#..####..#..#..#.....#....#.##.##........
........#.#.#..#.#...##....###.............#........#...#...#.#..#..........#........#....#...#.
..###......###....##..#.##...##.#.....#...#.........##.#.##.#.......#....######.#.##....##.#.##.
#..#..........#..#.##..#..#..#......##.......#....#.##.#...#.....##.......#.###..#..##.#..##.#..
###....#.#...#...##....##...........#............#........#.#...##........#....#.#.........#...#
...#.....#....#...#....#....#...##......#......#...###.#.....#.....#.#..#...#..#....#....#.#...#
.#.#...#.....#...##....#.#.....##.......#....#....####....##..#.##....#....#.........##.........
#....#...#...........##.#..##....##.................#.#..##.#.##.##..#.........##...##..#.......
...#.......#.##......#....#..###...........#.......#......#.##..#.#..##....#..#.#.....#......#..
..........##.#.....##...####..#.##....##....####..#.....#.#...#.#....##..#...###.......#......#.
#..#.#.....#......#.#..#....#.##.##.##..#..#....#....#....#.#..###..#..###...#....#.......##.#..
#....#..##...............#..#.#.#................#..##........#....#......#.........#.##.#.#....
..#..###.....#.#.........#.#.#...#..#......##........#..#....#...#####...##....##....#..#..##.#.
..##...##..##....##.#..#.......#................###......#..#.....#..####..#..#..#..#.#.........
#.....#.#.#.#....#.#..#..##.#.#.......#....#.#....###..##.##.......##........###..#.....##.....#
##.###.......#.........##.#....#.......##...##......#.......#...#.................##...#........
..#.#......#..##...#......#.#..........###.#..##..#.##..#.#..##.#..#...#.##.......#...........#.
#..##.#...#....#.#.....#.#......#.........#..#.##..#.##.##...#.##..##.#.##.....#.#.#......#.##.#
.......#..#......##.......#.....#..#...#.#........#......#....#...#..........#.#................
##.##..#...#...#.#...#.........##.#........#...........#.......#.....#...#.#..#....#...##..#.#.#
#........#..#..##..#...#.......##..#.#....#..##.....#....#.###..........#......#..#..#.#.##.....
.....#....##...###.#..###...##...###..#..###.#..##....##....#.##.#....#...#...#.##..#.#.#....##.
......#...#....####..####.##..##.#......#...##.#..#..#..#..####..##.#...#.....#...#........#...#
...#........#..#...#..#..#.#####.......#...#..#...#......#.....##.#.....##..#............#......
......#.#..#..#.......#..#....##..#............##.........#......#...#.##.###....##.....#.......